Абонемент – Абонент:Право пользования чем-либо в течение определённого срока, а также документ, удостоверяющий это право. – Владелец абонемента (лицо или учреждение). ###
Артистический – Артистичный:Относящийся к артисту; предназначенный для артиста; свойственный артисту, художнику, характерный для него. – Отличающийся артистизмом, художественным вкусом. ###
Бедный – Бедственный:1. обладающий очень скудным достатком, малоимущий или неимущий. 2. перен. имеющий недостаток в чём-либо, скудный. 3. только полн. ф. несчастный, возбуждающий сострадание, жалость. – Исполненный бедствий, лишений. ###
Безответный – Безответственный:1. не получающий, не дающий ответа, отклика на что-либо. 2. неспособный возражать, прекословить, очень кроткий. – Не несущий или не сознающий ответственности. ###
Болотистый – Болотный:Изобилующий болотами, заболоченный; топкий, как болото. – 1. относящийся к болоту, свойственный ему; предназначенный для работ на болоте, передвижения по болоту и т. п. 2. живущий, произрастающий на болоте. ###
Благодарный – Благодарственный:1. чувствующий или выражающий признательность. 2. перен. позволяющий ожидать хорошие результаты, оправдывающий затраченные силы, средства. – (устар.). только с неодуш. сущ. содержащий, заключающий в себе благодарность, признательность. ###
Благотворительный – Благотворный:Имеющий целью оказание материальной помощи нуждающимся. – Полезный, оказывающий хорошее действие. ###
Бывший – Былой:1. существовавший ранее. 2. переставший занимать должность, положение. – Минувший, прошлый, прежний. ###
Вдох – Вздох:Каждый отдельный впуск воздуха в лёгкие, каждое отдельное вдыхание. – Усиленный вдох и выдох (обычно как выражение какого-либо чувства). ###
Вековой – Вечный:Существующий долго, многие годы, столетия. – Бесконечный, без начала и конца, постоянный ###
Великий – Величественный:1. очень большой, огромный, превышающий обычную меру. 2. выдающийся, важный по значению. – 1. торжественный. 2. исполненный достоинства, важности. ###
Враждебный – Вражеский:Полный неприязни, ненависти. – Относящийся к неприятелю, врагу, противнику. ###
Выгода – Выгодность:Прибыль, доход, извлекаемый из чего-либо, польза. – Свойство, являющееся выгодным. ###
Выплатить – Заплатить:Выдать плату за что-либо. – 1. отдать плату за что-либо. 2. отплатить (ответить). ###
Вырастить – Нарастить – Отрастить:Ухаживая, обеспечить рост, развитие кого-либо или чего-либо, взрастить. – Способствовать росту чего-либо, удлинить; вырастить в каком-либо количестве; накопить. – Дать возможность достичь в росте каких-либо размеров, величины. ###
Высокий – Высотный:1. большой по протяжённости или далеко расположенный в направлении снизу вверх. 2. превышающий средний уровень, среднюю норму, значительный. 3. только полн. ф. выдающийся по значению, почётный, важный. 4. только полн. ф. возвышенный по содержанию, очень значительный, торжественный, не обыденный. 5. очень хороший по качеству, отличный. 6. о звуках: тонкий, звонкий, вызываемый колебаниями большой частоты. – 1. простирающийся выше известного предела; вызываемый большой высотой (спец.). 2. производящийся или используемый на большой высоте (авиа). 3. об архитектурных сооружениях: очень высокий, многоэтажный. ###
Гарантийный – Гарантированный:Прилагательное к существительному гарантия. содержащий гарантию, служащий гарантией. – Причастие от глагола гарантировать. обеспеченный. ###
Гармонический – Гармоничный:(спец.). относящийся к гармонии; основанный на принципах гармонии. – Содержащий элементы гармонии; обладающий согласованностью, слаженностью, взаимным соответствием разных качеств предметов, явлений, частей целого. ###
Глинистый – Глиняный:Содержащий глину, изобилующий глиной. – Сделанный из глины. ###
Годичный – Годовалый – Годовой:Продолжающийся в течение года, относящийся к целому году. – (разг.). в возрасте одного года; пролежавший, просуществовавший год. – 1. относящийся к целому году; получающийся к концу года, в итоге за год; рассчитанный на год. 2. совершающийся один раз в год. ###
Гордость – Гордыня:Чувство собственного достоинства, самоуважение, чувство удовлетворения от успехов; чрезмерно высокое мнение о себе. – Чрезмерная гордость. ###
Гуманизм – Гуманность:1. прогрессивное движение эпохи возрождения. 2. отношение к людям, проникнутое любовью к человеку и заботой о его благе. – Свойство, в основе которого значение прилагательного гуманный. ###
Гуманистический – Гуманитарный – Гуманный:Прилагательное к существительным гуманизм и гуманист. – Обращенный к человеческой личности, к правам и интересам человека; относящийся к общественным наукам, изучающим человека и его культуру. – Человечный, человеколюбивый, проникнутый любовью к человеку, уважением к личности. ###
Двоичный – Двойной – Двойственный – Двоякий – Сдвоенный – Удвоенный:Основанный на счёте двойками (парами), основанный на комбинации двух компонентов. – Состоящий из двух однородных или подобных частей, вдвое больше. – Противоречивый, двуличный, касающийся две стороны, двух участников. – Проявляющий себя в двух смыслах, видах. – Соединённый в один. – Увеличенный вдвое. ###
Действенный – Действительный – Действующий:Эффективный, способный влиять на результат. – 1. реально существующий. 2. имеющий силу, действующий, годный. – Нынешний, работающий ###
Деловитый – Деловой – Дельный – Деляческий:Умелый, толковый, предприимчивый. – 1. связанный с делом, с работой. 2. знающий, опытный в делах. – Способный к делу, к работе. – Основанный на узком практицизме, сугубо прагматичный. ###
Демократичный – Демократический:Основанный на принципах демократии, осуществляющий демократию, отражающий её, принадлежащий ей. (употребляется в словосочетаниях терминологического характера.) – Содержащий элементы демократичности, демократизма, простой, относящийся к народу. ###
Диктант – Диктат:(пед.). письменная работа, состоящая в записывании диктуемого текста. – Требование, указание, продиктованное одной, сильной стороной и навязанное для безусловного выполнения другой, слабой стороне. ###
Дипломант – Дипломат:1. лицо, награждённое дипломом за успешное выступление на конкурсе, фестивале и т. п. 2. студент, готовящий выпускную, дипломную работу. – 1. должностное лицо, занимающееся дипломатической деятельностью, работой в области внешних отношений. 2. перен. о человеке, действующем тонко, умело (разг.). ###
Дипломатический – Дипломатичный:Относящийся к дипломатии (в значении: деятельность по осуществлению внешней международной политики государства) и к дипломатам. – Ловкий, умело и тонко действующий; тонко рассчитанный. ###
Длинный – Длительный:1. имеющий большую длину, протяжённость; только кратк. ф. больший по длине, чем нужно; (разг.) о человеке: высокий ростом. 2. медленно тянущийся. – Долговременный. ###
Добротный – Добрый:Хорошо, прочно сделанный. – 1) отзывчивый, готовый помочь, расположенный к другим, 2) хороший, несущий радость, успех, благо. ###
Доверительный – Доверчивый:Выражающий доверие. – Доверяющий, питающий доверие. ###
Дождевой – Дождливый:Связанный с дождём, вызванный дождём, несущий дождь; предназначенный для защиты от дождя. – Обильный дождями. ###
Дружеский – Дружественный – Дружный:Относящийся к другу, принадлежащий, свойственный ему, характеризующий отношения друзей. – (офиц.). взаимно благожелательный, основанный на дружелюбии, выражающий расположение (преимущественно о государствах, народах и отношениях между ними). – Связанный дружбой, взаимным согласием, происходящий одновременно, согласованно. ###
Единичный – Единственный:Только один, единственный. отдельный, обособленный, индивидуальный. – Только один, такой, кроме которого нет никакого другого; исключительный. ###
Желанный – Желательный:1. очень ожидаемый, составляющий предмет желания. 2. только прил. милый, дорогой. – (книжн.). нужный для чего-либо, соответствующий чьим-либо желаниям, интересам, ожиданиям. ###
Жестокий – Жёсткий:1) безжалостный, беспощадный, слишком суровый, 2) слишком сильный. – 1) твёрдый на ощупь, крепкий, плотный, 2) суровый, резкий, 3) не допускающий отклонений. ###
Жизненный – Житейский:1) относящийся к жизни, 2) важный для жизни. – Обыденный, связанный с ежедневной жизнью. ###
Жилищный – Жилой:Прилагательное к существительному жилище. – Предназначенный для жилья. ###
Зачинатель – Зачинщик:Основоположник чего-либо. – Тот, кто начинает что-то неблаговидное. ###
Звериный – Зверский:Прилагательное к существительному зверь. присущий зверю, свойственный зверю; жестокий, свирепый; чрезмерно сильный. – Свойственный зверю, звериный; жестокий, свирепый, дикий; очень сильный, чрезвычайный. ###
Звуковой – Звучный:1. физический термин, относящийся к звуку. 2. записывающее или воспроизводящее устройство, аппарат. 3) состоящий из звуков. – Громкий, чистый, отчётливо звучащий. ###
Зрительный – Зрительский:1. относящийся к зрению. 2. предназначенный для зрителей. 3. такой, с помощью которого рассматривают что-либо. – Относящийся к зрителю, свойственный ему. ###
Изобретательный – Изобретательский:Находчивый, быстрый на выдумку, способный изобретать. – Относящийся к изобретательству, к изобретателю. ###
Информативный – Информационный:Несущий информацию, насыщенный информацией. – Относящийся к информации. ###
Информация – Информированность:Информирование; сообщение о положении дел, событиях; сведения об окружающем мире и протекающих в нем процессах, воспринимаемые человеком или специальными устройствами. – Осведомленность, степень владения информацией. ###
Иронический – Ироничный:Относящийся к иронии как стилистическому приёму. (употребляется в словосочетаниях терминологического характера.) – Содержащий элементы иронии, употребляющийся с целью насмешки. ###
Искусный – Искусственный:1. умелый, хорошо знающий своё дело. 2. умело, хорошо выполненный. – 1. только полн. ф. не природный, ненатуральный, сделанный наподобие настоящего, природного. 2. притворный, неискренний. ###
Исполнительный – Исполнительский:1. только полн. ф. имеющий своей задачей исполнение решений, постановлений, практически осуществляющий управление чем-либо. 2. старательный, точно и хорошо исполняющий обязанности, поручения. – Относящийся к исполнителю, к исполнению какого-либо художественного (музыкального, литературного, драматического) произведения. ###
Исходный – Исходящий:Начальный. – Термин документооборота. ###
Каменистый – Каменный:Обильный камнем, покрытый камнем. – 1. состоящий из камня, сделанный из камня или кирпича. 2. перен. неподвижный, застывший, безжизненный. 3. перен. безжалостный, жестокий. 4. составная часть ботанических, зоологических и минералогических названий. ###
Комфортабельный – Комфортный:Удобный, с комфортом, уютный. употребляется с сущ., обозначающими помещения, транспортные средства и составляющие интерьера. – Удобный, благоприятный для человека, его жизнедеятельности и самочувствия, доставляющий приятные ощущения. используется с существительными, обозначающими абстрактные понятия, действия и состояния. ###
Конный – Конский:1. связанный с лошадьми. 2. действующий с помощью лошадей. 3. состоящий из конницы, кавалерийский. – 1. принадлежащий коню, относящийся к нему, лошадиный. 2. составная часть некоторых ботанических названий. ###
Коренастый – Коренной – Корневой:Тип телосложения (невысокий, крепкий, мускулистый). – 1. изначальный, исконный, постоянный, основной. 2. касающийся самих основ, корней чего-либо, решающий, самый главный. 3. основной, центральный, стержневой (спец.). – 1. относящийся к корню растения. 2. представляющий собой корень, состоящий из корня, корней (лингв.). ###
Костный – Костяной:Прилагательное к существительному кость. добываемый из костей. – Сделанный из кости, добываемый из кости животных. ###
Красочный – Красящий – Крашеный:Яркий, сочный. – Причастие от глагола красить. содержащий краску, служащий для окрашивания. – Обработанный краской. ###
Лакированный – Лаковый:1. покрытый лаком. 2. перен. вылощенный, внешне блестящий, гладкий. – Прилагательное к существительному лак. покрытый лаком (сделанный из кожи, из дерева, папье-маше или металла, покрытых лаком). ###
Ледовый – Ледяной:Состоящий изо льда, ледяной; находящийся, расположенный на льду; происходящий во льдах. – Прилагательное к существительному лёд. состоящий изо льда, покрытый льдом; очень холодный (холодный как лёд); крайне сдержанный, презрительно-холодный, уничтожающий. ###
Лесистый – Лесной:Обильно поросший лесом. – Прилагательное к существительному лес. расположенный в лесу, живущий, растущий в лесу; покрытый лесами; относящийся к лесоводству. ###
Личностный – Личный:Относящийся к личности (книжн.). – Принадлежащий определенному лицу; принадлежащий личности; затрагивающий интересы какого-либо лица. ###
Микроскопический – Микроскопичный:1. производимый с помощью микроскопа. 2. различимый, видимый только в микроскоп. – Очень незначительный по величине, размеру, объёму. ###
Мороженый – Морозильный – Морозный:Подвергшийся замораживанию. – Предназначенный для замораживания. – Относящийся к морозу как явлению природы. ###
Надеть – Одеть:Что-то на себя. – Кого-то. ###
Наличие – Наличность:Присутствие. – Количество имеющегося в наличии в данный момент. ###
Напоминание – Упоминание:Слова с целью напомнить. – Слова, касающиеся кого-то, сказанные не специально, а вскользь. ###
Невежа – Невежда:Грубый, невоспитанный, невежливый человек. – Малообразованный человек, неуч; человек, несведущий в какой-либо области знания, профан. ###
Нестерпимый – Нетерпеливый – Нетерпимый:Превышающий терпение, с трудом переносимый. – 1. с трудом выносящий что-либо. 2. выражающий нетерпение. – 1. такой, с которым нельзя мириться, недопустимый. 2. не считающийся с чужим мнением, лишённый терпимости. ###
Неудачный – Неудачливый:1. сопровождающийся, закончившийся неудачей. 2. неудовлетворительный, не такой, каким должен быть. – Только с одуш. сущ. преследуемый неудачами. ###
Обвинённый – Обвинительный:Сужденный, привлеченный, укоренный, инкриминированный, упрекнутый в чём-либо. – Содержащий в себе обвинение, выражающий осуждение. ###
Обрывок – Отрывок:1. оторванный кусок. 2. часть. – Небольшая часть произведения, фрагмент. ###
Обхватить – Охватить:Заключив между распростёртыми руками, пальцами, лапами и т. д., плотно прижать кого-что-либо к себе. – 1. окружить, сжать. 2. перен. заключить в свои пределы, обнять, окутать. 3. только 3 л., перен. о чувствах, мыслях: овладеть полностью кем-чем-либо. 4. включить, ввести в круг чего-либо. 5. не отрываясь от своих частей, обойти противника с фланга (флангов) для нанесения удара. ###
Ограничить – Отграничить – Разграничить:Поставить в границы, рамки. – Отделить одно от другого или от всего прочего, установив границу. – Отделить друг от друга или одно от другого. ###
Оклик – Отклик:Возглас, которым окликают кого-либо, привлекают чьё-либо внимание, останавливают. – 1. ответ на зов, обращение; отзвук, эхо. 2. перен. отражение, след, пережиток чего-либо. 3. перен. выражение того или иного отношения к чему-либо. ###
Органический – Органичный:1. принадлежащий к растительному или животному миру, относящийся к живым организмам (спец.). 2. касающийся внутреннего строения человека, его организма, его органов. 3. касающийся самой сущности чего-либо, коренной. 4. перен. внутренне присущий кому-либо. – Органический присущий кому-чему-либо, не случайный, закономерно вытекающий из чего-либо. ###
Отборный – Отборочный:1. отобранный из других как лучший. 2. непристойный. – С целью отбора. ###
Отклонение – Уклонение:1. отказ. 2. отступление. – Отход от чего-либо. ###
Отклоняться – Уклоняться:Перемещаться в сторону. – 1. отклоняться, отодвигаться. 2. воздерживаться от чего-либо. 3. изменять первоначальное направление. ###
Отличать(-ся) – Различать(-ся):1. распознавать нечто среди прочего. 2. награждать, выделять (устар.). – Распознавать зрением или другими органами чувств. ###
Отличие – Различие:1. признак, создающий разницу. 2. заслуга (устар.). 3. знак, звание, грамота и другие показатели признания чьих-либо заслуг. – Разница, несходство. ###
Памятливый – Памятный:(разг.). только с одуш. сущ. обладающий хорошей памятью, способный легко запоминать, имеющий особенную склонность к запоминанию. – 1. сохранившийся в памяти, незабываемый. 2. только полн. ф. служащий для справок, записей, для сохранения чего-либо в памяти. ###
Перетерпеть – Претерпеть:Пережить, вынести что-то неприятное, тяжёлое. – Подвергнуться изменению. ###
Покупательный – Покупательский – Покупной:(экон.). относящийся к возможности купить. – Относящийся к покупателю, принадлежащий ему. – Относящийся к покупке; такой, который покупается, покупаемый. ###
Популистский – Популярный:Апеллирующий к широким массам и обещающий им скорое и лёгкое решение острых социальных проблем. – 1. понятный, доступный, несложный по изложению. 2. пользующийся широкой известностью, общественными симпатиями. ###
Практический – Практичный:1. относящийся к области практики. 2. нужный для практики; прививающий умение, навыки. 3. относящийся к области реальных потребностей. – 1. опытный, хорошо разбирающийся в жизненных делах. 2. удобный, пригодный в деле, выгодный, экономный. ###
Предоставить – Представить:1. отдать кого-что-либо в распоряжение, пользование кому-чему-либо. 2. дать возможность кому-либо сказать, сделать что-либо, чем-либо распорядиться. – 1. предъявить, сообщить что-либо кому-либо. 2. познакомить с кем-либо, дать возможность ознакомиться с чем-либо. 3. признав достойным чего-либо, ходатайствовать о чём-либо (о награде, повышении по службе и т. п.). 4. воспроизвести в мыслях, вообразить кого-что-либо (обычно со словом «себе»). 5. изобразить, показать кого-что-либо. ###
Представительный – Представительский:1. только полн. ф. выборный, основанный на представительстве. 2. вполне отражающий чьи-либо интересы, авторитетный. 3. внушающий почтение, важный (разг.) – (спец.). относящийся к представительству или представителю. ###
Признанный – Признательный:1) тот, кого признали (причастие от глагола признать). 2) оценённый по достоинству, известный. – Испытывающий или выражающий признательность, благодарность. ###
Продуктивный – Продуктовый:1. приносящий положительные результаты, создающий какие-либо ценности в процессе труда, производительный, плодотворный. 2. относящийся к разведению сортов растений и пород скота для получения продуктов сельского хозяйства (чаще животноводства). – Предназначенный для продуктов питания, связанный с торговлей или хранением продуктов. ###
Производительность – Производство:Способность выпускать определённое количество продукции. – 1. общественный процесс создания материальных благ, охватывающий как производительные силы общества, так и производственные отношения людей. 2. изготовление, выработка, создание какой-нибудь продукции. 3. отрасль промышленности. 4. работа по непосредственному изготовлению продукции. ###
Производительный – Производственный:Производящий, создающий, продуктивный. – 1. относящийся к производству. 2. занимающийся производством, участвующий в производстве. ###
Просветительский – Просвещённый:Относящийся к просветительству, просветителю, свойственный им. ###
Публицистический – Публицистичный:Относящийся к публицистике, к публицисту. – Затрагивающий злободневные общественно-политические вопросы. ###
Пугливый – Пуганый:Боязливый, пугающийся; выражающий боязливость. – Такой, которого часто пугали или который сильно напуган. ###
Раздражение – Раздражительность:Состояние возбуждения, взволнованности, чувство острого недовольства, досады, (биол.) реакция клетки на внешнее воздействие. – Свойство личности (по значению прилагательного раздражительный). ###
Ритмический – Ритмичный:Относящийся к ритмике, подчинённый ей. – Повторяющийся через равные промежутки чего-либо. ###
Романтический – Романтичный:1. относящийся к романтизму как направлению в литературе и искусстве и как художественному методу. (употребляется в словосочетаниях терминологического характера.) 2. свойственный романтику; исполненный романтики; эмоционально-приподнятый, привлекающий своей таинственностью. – Содержащий элементы романтизма, таинственности, мечтательности. ###
Скрытный – Скрытый:Не склонный делиться с другими своими мыслями, переживаниями, намерениями, неоткровенный. – Тайный, не обнаруживающийся явно. ###
Словарный – Словесный:Относящийся к словарю или работе по созданию словарей. – Выражаемый словами, в словах. ###
Сопротивление – Сопротивляемость:1) противодействие. 2) термин в физике: сопротивление как характеристика материалов. – Способность сопротивляться. ###
Соседний – Соседский:Расположенный вблизи, рядом с кем-чем-либо, по соседству. – (разг.). относящийся к соседу, принадлежащий ему. ###
Сравнимый – Сравнительный:Тот, который может сравниваться с чем-либо (сравнимый является причастием от глагола сравнить). – 1) основанный на сравнении, 2) относительный, 3) лингвистический термин, связанный со сравнением. ###
Сценический – Сценичный:1. относящийся к сцене. 2. связанный с театром, театральным искусством, театральной деятельностью. – Пригодный для сцены, для театрального представления, обладающий свойствами, нужными для сцены. ###
Технический – Техничный:1. относящийся к технике, связанный с ней, с научной разработкой её. 2. используемый в промышленности. 3. относящийся к обслуживанию техники какого-либо производства. 4. действующий только по указанию руководителя, не ответственный. – Обладающий мастерством, высокой техникой; исполненный с большим искусством, умением (в спорте, искусстве). ###
Удачливый – Удачный:Только с одуш. сущ. такой, которому всё удаётся, у которого всегда удача. – Только с неодуш. сущ. 1. завершившийся удачей, удавшийся. 2. хороший. ###
Униженный – Унизительный:Причастие от глагола унизить. тот, кого унизили; выражающий унижение, свидетельствующий об унижении. – Оскорбительный для чьего-либо достоинства, самолюбия. ###
Фактический – Фактичный:Являющийся фактом; отражающий действительное состояние чего-либо. – Соответствующий фактичности, требованиям подлинности, документальности. ###
Хищнический – Хищный:1. свойственный хищнику, грабительский. 2. перен. бесхозяйственный, бесплановый, преследующий цели ближайшей выгоды, обогащения. – 1. только полн. ф. о животных: питающийся животными. 2. перен. жадный, полный стремления овладеть кем-чем-либо, захватить что-либо, а также выражающий такое стремление; такой, как у хищника. ###
Царский – Царственный – Царствующий:Относящийся к царю, принадлежащий ему. 2. относящийся к политическому режиму монархии во главе с царём. 3. перен. роскошный, богатый. – Отличающийся величественностью, значительностью по размаху. – 1. тот, кто царствует, причастие от глагола царствовать. 2. главенствующий, довлеющий. ###
Целый – Цельный – Целостный:1. только полн. ф. весь без изъятия, полный. 2. только полн. ф. значительный, большой. 3. невредимый, без изъяна, ущерба. – 1. только полн. ф. из одного вещества, из одного куска, монолитный. 2. только полн. ф. не разбавленный, не снятой. 3. перен. обладающий внутренним единством. – Представляющий целостность, единство. ###
Экономический – Экономичный – Экономный:Относящийся к экономике, хозяйственный. – Дающий возможность что-либо сэкономить, выгодный. – 1. бережливо расходующий что-либо, соблюдающий экономию. 2. требующий умеренных затрат, способствующий экономии, скромный в расходах. ###
Эстетический – Эстетичный:1. относящийся к эстетике (науке о прекрасном в искусстве и в жизни, об общих законах художественного творчества). 2. связанный с созданием и восприятием прекрасного. – Красивый, изящный; содержащий элементы эстетизма. ###
Этический – Этичный:1. относящийся к этике (науке, объектом изучения которой является мораль). 2. соответствующий требованиям морали. – Допустимый с точки зрения требований этики (норм поведения). ###
Эффективный – Эффектный:Действенный, приводящий к нужным результатам. – Производящий впечатление. ###
Эффективность – Эффектность:Действенность, результативность – Броскость, способность производить впечатление ###